{
	"lvmap" : [
		0, 0, 0, 0, 0, 0, 0, 0, 0, 0,
		0, 0, 0, 0, 0, 0, 0, 0, 0, 0,
		0, 0, 0, 0, 1, 1, 1, 0, 0, 0,
		0, 0, 0, 0, 1, 0, 1, 0, 0, 0,
		0, 0, 1, 1, 1, 0, 1, 0, 0, 0,
		0, 0, 1, 0, 0, 0, 1, 0, 1, 1,
		1, 1, 1, 0, 0, 0, 1, 0, 1, 0,
		0, 0, 0, 0, 0, 0, 1, 1, 1, 0,
		0, 0, 0, 0, 0, 0, 0, 0, 0, 0
	],
	"lvpath" : [60, 61, 62, 52, 42, 43, 44, 34, 24, 25, 26, 36, 46, 56, 66, 76, 77, 78, 68, 58, 59],
	"lvshort" : [],
	"lvdirection" : [0, 2],
	"lvgold" : 15,
	"lvwaves" : [
		[1, 0, 0, 0, 0, 0, 0, 1],
		[1, 0, 0, 0, 0, 0, 0, 1, 0, 0, 0, 0, 0, 0, 1, 0, 0, 0, 0, 0, 0, 1, 0, 0, 0, 0, 0, 0, 1],
		[1, 0, 0, 0, 0, 0, 1, 0, 0, 0, 0, 0, 1, 0, 0, 0, 0, 0, 1, 0, 0, 0, 0, 0, 1],
		[1, 0, 0, 0, 1, 0, 0, 0, 1, 0, 0, 0, 1, 0, 0, 1, 0, 0, 1],
		[1, 0, 1, 0, 2, 0, 1, 0, 1, 0, 1, 0],
		[1, 0, 1, 0, 2, 2, 1, 0, 1, 0, 2],
		[2, 1, 1, 0, 2, 2, 1, 1, 1, 0, 2, 0, 0, 0, 1, 1, 1],
		[2, 1, 1, 0, 2, 2, 1, 1, 1, 0, 2, 0, 0, 0, 1, 1, 1, 2, 1, 1, 0, 2, 2, 1, 1, 1, 0, 2, 0, 0, 0, 1, 1, 1],
		[2, 1, 1, 0, 2, 2, 1, 1, 1, 0, 2, 0, 0, 0, 1, 1, 1, 2, 1, 1, 0, 2, 2, 1, 1, 1, 0, 2, 0, 2, 0, 1, 1, 1],
		[2, 2, 2, 2, 2, 2, 1, 1, 1, 0, 2, 0, 0, 0, 1, 1, 1, 2, 1, 1, 0, 2, 2, 1, 1, 1, 0, 2, 2, 2, 2, 1, 1, 1, 2, 2, 2, 1, 1, 1],
		[2, 1, 2, 1, 2, 1, 2, 1, 2, 1, 2, 1, 2, 1, 2, 1, 2, 1, 2, 1, 2, 1, 2, 1, 2, 1, 2, 1, 2, 1, 2, 1, 2, 2, 2, 1, 1, 1, 2, 2, 2],
		[3, 0, 0, 0, 1, 0, 1, 0, 1, 0, 1, 0],
		[3, 0, 3, 0, 0, 0, 2, 0, 2, 0, 2, 0],
		[2, 2, 2, 2, 0, 0, 0, 4, 4, 4, 4, 4, 0, 4, 4, 4, 4, 0, 0, 2, 2, 2, 2, 0, 0, 0, 4, 4, 4, 4, 4, 0, 4, 4, 4, 4, 0, 0],
		[2, 2, 2, 2, 1, 1, 1, 1, 2, 2, 0, 0, 0, 4, 4, 4, 4, 2, 2, 2, 2, 1, 1, 1, 1, 2, 2, 0, 0, 0, 4, 4, 4, 4],
		[3, 0, 0, 3, 0, 0, 3, 0, 0, 3, 0, 0, 0, 0, 4, 4, 4, 2, 0, 2, 0, 2, 0, 4, 4, 4, 4],
		[3, 0, 0, 0, 3, 0, 0, 0, 0, 3, 0, 0, 3, 0, 0, 0, 3, 0, 0, 3, 0, 0, 0, 0, 0, 0, 4, 4, 4, 4, 4, 4, 4, 4, 0, 0, 0, 0, 0, 4, 4, 4, 4, 4, 4, 4, 4],
		[5, 0, 0, 0, 5, 0, 0, 0, 5, 5, 0, 0, 0, 5, 0, 0, 0, 5],
		[5, 0, 3, 0, 5, 0, 3, 0, 0, 3, 0, 5, 0, 3, 0, 5],
		[5, 0, 3, 0, 5, 0, 3, 0, 5, 0, 3, 0, 5, 0, 3, 0, 5, 3, 0, 0, 0, 3, 0, 0, 0, 0, 3, 0, 0, 3, 0, 0, 0, 3, 0, 0, 3, 0, 0, 0, 0, 0, 0, 4, 4, 4, 4, 4, 4, 4, 4, 0, 0, 0, 0, 0, 4, 4, 4, 4, 4, 4, 4, 4],
		[5, 0, 5, 0, 5, 0, 5, 0, 5, 5, 0, 5, 0, 5, 0, 5, 0, 5, 5, 0, 0, 0, 3, 0, 0, 0, 0, 3, 0, 0, 3, 0, 0, 0, 3, 0, 0, 3, 0, 0, 0, 0, 0, 0, 4, 4, 4, 4, 4, 4, 4, 4, 0, 0, 0, 0, 0, 4, 4, 4, 4, 4, 4, 4, 4],
		[6, 0, 0, 0, 6, 0, 0, 0, 6, 0, 0, 0, 6, 0, 0, 0, 6],
		[6, 0, 0, 0, 6, 0, 0, 0, 6, 0, 0, 0, 6, 0, 0, 0, 6, 0, 0, 0, 6, 0, 0, 0, 6, 0, 0, 0, 6, 0, 0, 0, 6]], 
	"lvbg" : "url(assets/img/lvl1bg.png)",
	"lvindex" : 4,
	"hardmode" : true,
	"lvbgm" : "lvl4"
}