{
	"lvmap" : [
		0, 0, 0, 0, 0, 0, 0, 0, 0, 0,
		0, 0, 0, 0, 0, 0, 0, 0, 0, 0,
		0, 0, 0, 0, 1, 1, 1, 0, 0, 0,
		0, 0, 0, 0, 1, 0, 1, 0, 0, 0,
		0, 0, 1, 1, 1, 0, 1, 0, 0, 0,
		0, 0, 1, 0, 0, 0, 1, 0, 1, 1,
		1, 1, 1, 0, 0, 0, 1, 0, 1, 0,
		0, 0, 0, 0, 0, 0, 1, 1, 1, 0,
		0, 0, 0, 0, 0, 0, 0, 0, 0, 0
	],
	"lvpath" : [60, 61, 62, 52, 42, 43, 44, 34, 24, 25, 26, 36, 46, 56, 66, 76, 77, 78, 68, 58, 59],
	"lvshort" : [60, 61, 62, 52, 42, 43, 44, 34, 24, 25, 26, 36, 46, 56, 66, 76, 77, 78, 68, 58, 59],
	"lvdirection" : [0, 2],
	"lvgold" : 1000,
	"lvwaves" : [
		[1, 0, 0, 0, 0, 0, 0, 1],
		[1, 0, 12, 0, 0, 12, 0, 1],
		[9, 0, 9, 0, 12, 0, 6, 0, 6, 0, 6, 0, 6, 0, 6, 0, 6, 0, 6, 0, 6, 0, 6, 0, 6, 0, 8, 0, 8, 0, 8, 0, 8, 0, 8, 0, 8, 0, 8, 0, 12, 8, 0, 6, 0, 6, 0, 6, 0, 6, 0, 7, 7, 7, 7, 7, 7, 7, 7, 7, 7, 8, 0, 8, 0, 8, 0, 8, 0, 8, 0, 6, 6, 6, 6, 6, 6, 6, 6, 6, 6, 6, 6, 6, 6, 0, 3, 9, 3, 9, 3, 9, 3, 9, 3, 0, 0, 12, 0, 0, 0, 7, 7, 7, 7, 7, 7, 7, 7, 7, 7, 7, 7, 7, 7, 7, 7, 7, 7, 7, 7, 8, 0, 8, 0, 8, 0, 8, 0, 8, 0, 8, 0, 8, 0, 6, 0, 6, 0, 6, 0, 6, 0, 9, 12, 7, 7, 7, 7, 7, 7, 7, 7, 7, 7, 8, 0, 8, 0, 8, 0, 8, 0, 8, 0, 3, 9, 3, 8, 3, 9, 3, 8, 3, 11, 11, 0, 0, 0, 7, 7, 7, 7, 7, 7, 7, 7, 7, 7, 7, 7, 7, 7, 7, 7, 7, 7, 7, 7]], 
	"lvbg" : "url(assets/img/lvl1bg.png)",
	"lvindex" : 1,
	"hardmode" : false,
	"lvbgm" : "lvl1"
}