{
	"lvmap" : [
		0, 0, 0, 0, 0, 0, 0, 0, 0, 0,
		0, 0, 0, 0, 0, 0, 0, 0, 0, 0,
		0, 0, 0, 0, 1, 1, 1, 0, 0, 0,
		0, 0, 0, 0, 1, 0, 1, 0, 0, 0,
		0, 0, 1, 1, 1, 0, 1, 0, 0, 0,
		0, 0, 1, 0, 0, 0, 1, 0, 1, 1,
		1, 1, 1, 0, 0, 0, 1, 0, 1, 0,
		0, 0, 0, 0, 0, 0, 1, 1, 1, 0,
		0, 0, 0, 0, 0, 0, 0, 0, 0, 0
	],
	"lvpath" : [60, 61, 62, 52, 42, 43, 44, 34, 24, 25, 26, 36, 46, 56, 66, 76, 77, 78, 68, 58, 59],
	"lvshort" : [],
	"lvdirection" : [0, 2],
	"lvgold" : 15,
	"lvwaves" : [
		[1, 0, 0, 0, 0, 0, 0, 1]], 
	"lvbg" : "url(assets/img/lvl1bg.png)",
	"lvindex" : 1,
	"hardmode" : false,
	"lvbgm" : "lvl1"
}