{
	"lvmap" : [
		0, 0, 0, 0, 0, 0, 0, 0, 0, 0,
		0, 0, 1, 1, 1, 0, 0, 0, 0, 0,
		1, 1, 1, 0, 1, 1, 1, 1, 1, 0,
		0, 0, 0, 0, 0, 2, 0, 0, 1, 0,
		0, 1, 1, 1, 1, 1, 1, 1, 1, 0,
		0, 1, 0, 2, 0, 0, 0, 0, 0, 0,
		0, 1, 1, 1, 0, 1, 1, 1, 1, 1,
		0, 0, 0, 1, 1, 1, 0, 0, 0, 0,
		0, 0, 0, 0, 0, 0, 0, 0, 0, 0
	],
	"lvpath" : [20, 21, 22, 12, 13, 14, 24, 25, 26, 27, 28, 38, 48, 47, 46, 45, 44, 43, 42, 41, 51, 61, 62, 63, 73, 74, 75, 65, 66, 67, 68, 69],
	"lvshort" : [20, 21, 22, 12, 13, 14, 24, 25, 35, 45, 44, 43, 53, 63, 73, 74, 75, 65, 66, 67, 68, 69],
	"lvdirection" : [0, 2],
	"lvgold" : 15,
	"lvwaves" : [
		[1, 0, 0, 0, 0, 0, 0, 0, 1, 0, 0, 0, 0, 0, 0, 0, 1],
		[1, 0, 0, 0, 1, 0, 0, 0, 1, 0, 0, 0, 1, 0, 0, 0, 1],
		[1, 0, 0, 0, 1, 0, 0, 0, 1, 0, 0, 0, 1, 0, 0, 0, 1],
		[1, 0, 0, 0, 0, 0, 0, 1, 0, 0, 0, 0, 0, 7, 0, 0, 7],
		[1, 0, 0, 2, 0, 0, 0, 1, 0, 0, 2, 0, 0, 1, 0],
		[1, 0, 1, 0, 2, 0, 1, 0, 1, 0, 1, 0, 7, 7, 7],
		[1, 0, 1, 0, 2, 2, 1, 0, 1, 0, 2],
		[2, 1, 1, 0, 2, 2, 1, 1, 1, 0, 2, 0, 0, 0, 1, 1, 1],
		[2, 1, 1, 0, 2, 2, 1, 1, 1, 0, 2, 0, 0, 0, 1, 1, 1, 2, 1, 1, 0, 2, 2, 1, 1, 1, 0, 2, 0, 0, 0, 1, 1, 1],
		[2, 1, 1, 0, 2, 2, 1, 1, 1, 0, 2, 0, 0, 0, 1, 1, 1, 2, 1, 1, 0, 2, 2, 1, 1, 1, 0, 2, 0, 2, 0, 1, 1, 1, 2, 1, 1, 0, 2, 2, 1, 1, 1, 0, 2, 0, 0, 0, 1, 1, 1, 2, 1, 1, 0, 2, 2, 1, 1, 1, 0, 2, 0, 2, 0, 1, 1, 1],
		[2, 2, 2, 2, 2, 2, 1, 1, 1, 0, 2, 0, 0, 0, 1, 1, 1, 2, 1, 1, 0, 2, 2, 1, 1, 1, 0, 2, 2, 2, 2, 1, 1, 1, 2, 2, 2, 1, 1, 1, 0, 0, 0, 0, 7, 7, 7, 7, 7, 7, 7, 7, 7, 7, 7, 7, 7, 7, 7, 7, 7],
		[8, 0, 0, 8, 0, 0, 8, 0, 0, 8, 0, 0, 8, 0, 0, 8, 0, 0, 8, 0, 0, 8],
		[5, 0, 0, 5, 0, 0, 5, 0, 0, 5, 0, 0, 5, 0, 0, 0, 0, 7, 7, 7, 7, 7, 7, 7, 7, 7],
		[9, 0, 0, 0, 0, 0, 0, 0, 0, 0, 0, 0, 0, 0, 0, 0, 0, 9],
		[3, 3, 3, 3, 3, 3, 0, 0, 0, 0, 0, 0, 0, 0, 0, 0, 0, 8, 0, 0, 8, 0, 0, 8, 0, 0, 8, 0, 0, 0, 0, 0, 0, 2, 7, 2, 7, 2, 7, 2, 7, 2, 7, 2, 7, 2, 7, 2, 7, 2, 7, 2, 7, 2, 7, 2, 7, 2, 1, 2, 1, 2, 1, 2, 1, 2, 2, 2, 1, 1, 1, 2, 2, 2],
		[5, 0, 5, 0, 5, 0, 5, 0, 5, 5, 0, 5, 0, 5, 0, 5, 0, 5, 5, 0, 0, 0, 8, 0, 0, 0, 0, 8, 0, 0, 8, 0, 0, 0, 8, 0, 0, 8, 0, 0, 0, 0, 0, 0, 7, 7, 7, 7, 7, 7, 7, 7, 0, 0, 0, 0, 0, 4, 4, 4, 4, 4, 4, 4, 4],
		[6, 0, 0, 0, 6, 0, 0, 0, 6, 0, 0, 0, 6, 0, 0, 0, 6, 0, 0, 0, 8, 0, 0, 8, 0, 0, 8, 0, 0, 8, 0, 0, 8],
		[9, 0, 0, 0, 0, 9, 0, 0, 0, 0, 9],
		[6, 0, 0, 0, 6, 0, 0, 0, 6, 0, 0, 0, 6, 0, 0, 0, 6, 0, 0, 0, 6, 0, 0, 0, 6, 0, 0, 0, 6, 0, 0, 0, 6, 8, 0, 0, 8, 0, 0, 8, 0, 0, 8, 0, 0, 8, 6, 0, 0, 0, 6, 0, 0, 0, 6, 0, 0, 0, 6, 0, 0, 0, 6, 0, 0, 0, 6, 0, 0, 0, 6, 0, 0, 0, 6, 0, 0, 0, 6, 0, 0, 0, 0, 0, 0, 0, 0, 8, 0, 0, 8, 0, 0, 8, 0, 0, 8, 0, 0, 8],
		[6, 0, 0, 0, 6, 0, 0, 0, 6, 0, 0, 0, 6, 0, 0, 0, 6, 0, 0, 0, 8, 0, 0, 8, 0, 0, 8, 0, 0, 8, 0, 0, 8, 5, 0, 5, 0, 5, 0, 5, 0, 5, 5, 0, 5, 0, 5, 0, 5, 0, 5, 5, 0, 0, 0, 6, 0, 6, 0, 6, 0, 6, 0, 6, 0, 6, 0, 6, 0, 6, 0, 6, 8, 0, 0, 0, 0, 8, 0, 0, 8, 0, 0, 0, 8, 0, 0, 8, 0, 0, 0, 0, 0, 0, 7, 7, 7, 7, 7, 7, 7, 7, 0, 0, 0, 0, 0, 4, 4, 4, 4, 4, 4, 4, 4],
		[6, 0, 0, 0, 6, 0, 0, 0, 6, 0, 0, 0, 6, 0, 0, 0, 6, 0, 0, 0, 8, 0, 0, 8, 0, 0, 8, 0, 0, 8, 0, 0, 8, 5, 0, 5, 0, 5, 0, 5, 0, 5, 5, 0, 5, 0, 5, 0, 5, 0, 5, 5, 0, 0, 0, 6, 0, 6, 0, 6, 0, 6, 0, 6, 0, 6, 0, 6, 0, 6, 0, 6, 5, 5, 5, 5, 5, 5, 5, 8, 0, 0, 0, 0, 8, 0, 0, 8, 0, 0, 0, 8, 0, 0, 8, 0, 0, 0, 0, 0, 0, 7, 7, 7, 7, 7, 7, 7, 7],
		[6, 0, 6, 0, 6, 0, 6, 0, 6, 0, 6, 0, 6, 0, 6, 0, 6, 0, 6, 0, 8, 0, 8, 0, 8, 0, 8, 0, 8, 0, 8, 0, 8, 0, 8, 0, 6, 0, 6, 0, 6, 0, 6, 0, 7, 7, 7, 7, 7, 7, 7, 7, 7, 7, 8, 0, 8, 0, 8, 0, 8, 0, 8, 0, 6, 6, 6, 6, 6, 6, 6, 6, 6, 6, 6, 6, 6, 6, 0, 0, 0, 0, 0, 0, 0, 0, 0, 0, 0, 0, 0, 0, 0, 7, 7, 7, 7, 7, 7, 7, 7, 7, 7, 7, 7, 7, 7, 7, 7, 7, 7, 7, 7],
		[6, 0, 6, 0, 6, 0, 6, 0, 6, 0, 6, 0, 6, 0, 6, 0, 6, 0, 6, 0, 8, 0, 8, 0, 8, 0, 8, 0, 8, 0, 8, 0, 8, 0, 8, 0, 6, 0, 6, 0, 6, 0, 6, 0, 7, 7, 7, 7, 7, 7, 7, 7, 7, 7, 8, 0, 8, 0, 8, 0, 8, 0, 8, 0, 6, 6, 6, 6, 6, 6, 6, 6, 6, 6, 6, 6, 6, 6, 0, 0, 0, 0, 0, 0, 0, 0, 0, 0, 0, 0, 0, 0, 0, 7, 7, 7, 7, 7, 7, 7, 7, 7, 7, 7, 7, 7, 7, 7, 7, 7, 7, 7, 7, 8, 0, 8, 0, 8, 0, 8, 0, 8, 0, 8, 0, 8, 0, 6, 0, 6, 0, 6, 0, 6, 0, 7, 7, 7, 7, 7, 7, 7, 7, 7, 7, 8, 0, 8, 0, 8, 0, 8, 0, 8, 0, 0, 0, 0, 0, 0, 0, 0, 0, 0, 0, 0, 0, 0, 0, 0, 7, 7, 7, 7, 7, 7, 7, 7, 7, 7, 7, 7, 7, 7, 7, 7, 7, 7, 7, 7],
		[9, 0, 0, 0, 0, 6, 0, 6, 0, 6, 0, 6, 0, 6, 0, 6, 0, 6, 0, 6, 0, 6, 0, 6, 0, 8, 0, 8, 0, 8, 0, 8, 0, 8, 0, 8, 0, 8, 0, 8, 0, 6, 0, 6, 0, 6, 0, 6, 0, 7, 7, 7, 7, 7, 7, 7, 7, 7, 7, 8, 0, 8, 0, 8, 0, 8, 0, 8, 0, 6, 6, 6, 6, 6, 6, 6, 6, 6, 6, 6, 6, 6, 6, 0, 0, 0, 0, 0, 0, 0, 0, 0, 0, 0, 0, 0, 0, 0, 7, 7, 7, 7, 7, 7, 7, 7, 7, 7, 7, 7, 7, 7, 7, 7, 7, 7, 7, 7, 8, 0, 8, 0, 8, 0, 8, 0, 8, 0, 8, 0, 8, 0, 6, 0, 6, 0, 6, 0, 6, 0, 9, 7, 7, 7, 7, 7, 7, 7, 7, 7, 7, 8, 0, 8, 0, 8, 0, 8, 0, 8, 0, 0, 0, 0, 0, 0, 0, 0, 0, 0, 0, 0, 0, 0, 0, 0, 7, 7, 7, 7, 7, 7, 7, 7, 7, 7, 7, 7, 7, 7, 7, 7, 7, 7, 7, 7]
	],
	"lvbg" : "url(assets/img/lvl2bg.png)",
	"lvindex" : 2,
	"hardmode" : false,
	"lvbgm" : "lvl2"
}