{
	"lvmap" : [
		0, 0, 1, 0, 0, 0, 0, 0, 0, 0,
		0, 0, 1, 0, 0, 0, 0, 0, 0, 0,
		0, 0, 1, 1, 1, 1, 1, 1, 1, 0,
		0, 0, 0, 0, 0, 3, 2, 0, 1, 0,
		0, 0, 0, 0, 0, 3, 2, 3, 1, 0,
		0, 1, 1, 1, 1, 1, 1, 1, 1, 0,
		0, 1, 3, 3, 0, 0, 0, 0, 0, 0,
		0, 1, 1, 1, 1, 1, 1, 1, 1, 1,
		0, 0, 0, 0, 0, 0, 0, 0, 0, 0
	],
	"lvpath" : [2, 12, 22, 23, 24, 25, 26, 27, 28, 38, 48, 58, 57, 56, 55, 54, 53, 52, 51, 61, 71, 72, 73, 74, 75, 76, 77, 78, 79],
	"lvshort" : [2, 12, 22, 23, 24, 25, 26, 36, 46, 56, 55, 54, 53, 52, 51, 61, 71, 72, 73, 74, 75, 76, 77, 78, 79],
	"lvdirection" : [1, 2],
	"lvgold" : 15,
	"lvwaves" : [[1, 0, 0, 0, 0, 0, 0, 0, 1, 0, 0, 0, 0, 0, 0, 0, 1],
	[1, 0, 0, 0, 1, 0, 0, 0, 1, 0, 0, 0, 1, 0, 0, 0, 1],
	[1, 0, 0, 0, 1, 0, 0, 0, 1, 0, 0, 0, 1, 0, 0, 0, 1],
	[1, 0, 0, 0, 0, 0, 0, 1, 0, 0, 0, 0, 0, 7, 0, 0, 0, 7],
	[1, 0, 0, 2, 0, 0, 0, 1, 0, 0, 2, 0, 0, 1, 0],
	[1, 0, 1, 0, 2, 0, 1, 0, 1, 0, 1, 0, 7, 7, 7],
	[1, 0, 1, 0, 2, 2, 1, 0, 1, 0, 2],
	[2, 1, 1, 0, 2, 2, 1, 1, 1, 0, 2, 0, 0, 0, 1, 1, 1],
	[2, 1, 1, 0, 2, 2, 1, 1, 1, 0, 2, 0, 0, 0, 1, 1, 1, 2, 1, 1, 0, 2, 2, 1, 1, 1, 0, 2, 0, 0, 0, 1, 1, 1],
	[2, 1, 1, 0, 2, 2, 1, 1, 1, 0, 2, 0, 0, 0, 1, 1, 1, 2, 1, 1, 0, 2, 2, 1, 1, 1, 0, 2, 0, 2, 0, 1, 1, 1, 2, 1, 1, 0, 2, 2, 1, 1, 1, 0, 2, 0, 0, 0, 1, 1, 1, 2, 1, 1, 0, 2, 2, 1, 1, 1, 0, 2, 0, 2, 0, 1, 1, 1],
	[2, 1, 1, 0, 2, 2, 1, 1, 1, 0, 2, 0, 0, 0, 1, 1, 1, 2, 1, 1, 0, 2, 2, 1, 1, 1, 0, 2, 0, 2, 0, 1, 1, 1, 2, 1, 1, 0, 2, 2, 1, 1, 1, 0, 2, 0, 0, 0, 1, 1, 1, 2, 1, 1, 0, 2, 2, 1, 1, 1, 0, 2, 0, 2, 0, 1, 1, 1],
	[2, 2, 2, 2, 2, 2, 1, 1, 1, 0, 2, 0, 0, 0, 1, 1, 1, 2, 1, 1, 0, 2, 2, 1, 1, 1, 0, 2, 2, 2, 2, 1, 1, 1, 2, 2, 2, 1, 1, 1, 0, 0, 0, 0, 7, 7, 7, 7, 7, 7, 7, 7, 7, 7, 7, 7, 7, 7, 7, 7, 7],
	[2, 2, 2, 2, 2, 2, 1, 1, 1, 0, 2, 0, 0, 0, 1, 1, 1, 2, 1, 1, 0, 2, 2, 1, 1, 1, 0, 2, 2, 2, 2, 1, 1, 1, 2, 2, 2, 1, 1, 1, 0, 0, 0, 0, 7, 7, 7, 7, 7, 7, 7, 7, 7, 7, 7, 7, 7, 7, 7, 7, 7],
	[8, 0, 0, 8, 0, 0, 8, 0, 0, 8, 0, 0, 8, 0, 0, 8, 0, 0, 8, 0, 0, 8],
	[5, 0, 0, 5, 0, 0, 5, 0, 0, 5, 0, 0, 5, 0, 0, 0, 0, 7, 7, 7, 7, 7, 7, 7, 7, 7],
	[9, 0, 0, 0, 0, 0, 0, 0, 0, 0, 0, 0, 0, 0, 0, 0, 0, 9],
	[9, 0, 0, 0, 0, 9, 0, 0, 0, 0, 9],
	[3, 3, 3, 3, 3, 3, 0, 0, 0, 0, 0, 0, 0, 0, 0, 0, 0, 8, 0, 0, 8, 0, 0, 8, 0, 0, 8, 0, 0, 0, 0, 0, 0, 2, 7, 2, 7, 2, 7, 2, 7, 2, 7, 2, 7, 2, 7, 2, 7, 2, 7, 2, 7, 2, 7, 2, 7, 2, 1, 2, 1, 2, 1, 2, 1, 2, 2, 2, 1, 1, 1, 2, 2, 2],
	[5, 0, 5, 0, 5, 0, 5, 0, 5, 5, 0, 5, 0, 5, 0, 5, 0, 5, 5, 0, 0, 0, 8, 0, 0, 0, 0, 8, 0, 0, 8, 0, 0, 0, 8, 0, 0, 8, 0, 0, 0, 0, 0, 0, 7, 7, 7, 7, 7, 7, 7, 7, 0, 0, 0, 0, 0, 4, 4, 4, 4, 4, 4, 4, 4],
	[6, 0, 0, 0, 6, 0, 0, 0, 6, 0, 0, 0, 6, 0, 0, 0, 6, 0, 0, 0, 8, 0, 0, 8, 0, 0, 8, 0, 0, 8, 0, 0, 8],
	[6, 0, 0, 0, 6, 0, 0, 0, 6, 0, 0, 0, 6, 0, 0, 0, 6, 0, 0, 0, 6, 0, 0, 0, 6, 0, 0, 0, 6, 0, 0, 0, 6, 8, 0, 0, 8, 0, 0, 8, 0, 0, 8, 0, 0, 8, 6, 0, 0, 0, 6, 0, 0, 0, 6, 0, 0, 0, 6, 0, 0, 0, 6, 0, 0, 0, 6, 0, 0, 0, 6, 0, 0, 0, 6, 0, 0, 0, 6, 0, 0, 0, 0, 0, 0, 0, 0, 8, 0, 0, 8, 0, 0, 8, 0, 0, 8, 0, 0, 8],
	[6, 0, 0, 0, 6, 0, 0, 0, 6, 0, 0, 0, 6, 0, 0, 0, 6, 0, 0, 0, 8, 0, 0, 8, 0, 0, 8, 0, 0, 8, 0, 0, 8, 5, 0, 5, 0, 5, 0, 5, 0, 5, 5, 0, 5, 0, 5, 0, 5, 0, 5, 5, 0, 0, 0, 6, 0, 6, 0, 6, 0, 6, 0, 6, 0, 6, 0, 6, 0, 6, 0, 6, 8, 0, 0, 0, 0, 8, 0, 0, 8, 0, 0, 0, 8, 0, 0, 8, 0, 0, 0, 0, 0, 0, 7, 7, 7, 7, 7, 7, 7, 7, 0, 0, 0, 0, 0, 4, 4, 4, 4, 4, 4, 4, 4],
	[6, 0, 0, 0, 6, 0, 0, 0, 6, 0, 0, 0, 6, 0, 0, 0, 6, 0, 0, 0, 8, 0, 0, 8, 0, 0, 8, 0, 0, 8, 0, 0, 8, 5, 0, 5, 0, 5, 0, 5, 0, 5, 5, 0, 5, 0, 5, 0, 5, 0, 5, 5, 0, 0, 0, 6, 0, 6, 0, 6, 0, 6, 0, 6, 0, 6, 0, 6, 0, 6, 0, 6, 5, 5, 5, 5, 5, 5, 5, 8, 0, 0, 0, 0, 8, 0, 0, 8, 0, 0, 0, 8, 0, 0, 8, 0, 0, 0, 0, 0, 0, 7, 7, 7, 7, 7, 7, 7, 7],
	[6, 0, 6, 0, 6, 0, 6, 0, 6, 0, 6, 0, 6, 0, 6, 0, 6, 0, 6, 0, 8, 0, 8, 0, 8, 0, 8, 0, 8, 0, 8, 0, 8, 0, 8, 0, 6, 0, 6, 0, 6, 0, 6, 0, 7, 7, 7, 7, 7, 7, 7, 7, 7, 7, 8, 0, 8, 0, 8, 0, 8, 0, 8, 0, 6, 6, 6, 6, 6, 6, 6, 6, 6, 6, 6, 6, 6, 6, 0, 0, 0, 0, 0, 0, 0, 0, 0, 0, 0, 0, 0, 0, 0, 7, 7, 7, 7, 7, 7, 7, 7, 7, 7, 7, 7, 7, 7, 7, 7, 7, 7, 7, 7],
	[6, 0, 6, 0, 6, 0, 6, 0, 6, 0, 6, 0, 6, 0, 6, 0, 6, 0, 6, 0, 8, 0, 8, 0, 8, 0, 8, 0, 8, 0, 8, 0, 8, 0, 8, 0, 6, 0, 6, 0, 6, 0, 6, 0, 7, 7, 7, 7, 7, 7, 7, 7, 7, 7, 8, 0, 8, 0, 8, 0, 8, 0, 8, 0, 6, 6, 6, 6, 6, 6, 6, 6, 6, 6, 6, 6, 6, 6, 0, 0, 0, 0, 0, 0, 0, 0, 0, 0, 0, 0, 0, 0, 0, 7, 7, 7, 7, 7, 7, 7, 7, 7, 7, 7, 7, 7, 7, 7, 7, 7, 7, 7, 7, 8, 0, 8, 0, 8, 0, 8, 0, 8, 0, 8, 0, 8, 0, 6, 0, 6, 0, 6, 0, 6, 0, 7, 7, 7, 7, 7, 7, 7, 7, 7, 7, 8, 0, 8, 0, 8, 0, 8, 0, 8, 0, 7, 7, 7, 7, 7, 7, 7, 7, 7, 7, 7, 7, 7, 7, 7, 7, 7, 7, 7, 7],
	[9, 0, 0, 0, 0, 8, 0, 0, 8, 0, 0, 8, 0, 0, 8, 0, 0, 8, 0, 0, 8, 0, 0, 8, 0, 0, 8, 0, 0, 0, 0, 9],
	[6, 0, 6, 0, 6, 0, 6, 0, 6, 0, 6, 0, 6, 0, 6, 0, 6, 0, 6, 0, 8, 0, 8, 0, 8, 0, 8, 0, 8, 0, 8, 0, 8, 0, 8, 0, 6, 0, 6, 0, 6, 0, 6, 0, 7, 7, 7, 7, 7, 7, 7, 7, 7, 7, 8, 0, 8, 0, 8, 0, 8, 0, 8, 0, 6, 6, 6, 6, 6, 6, 6, 6, 6, 6, 6, 6, 6, 6, 0, 0, 0, 0, 0, 0, 0, 0, 0, 0, 0, 0, 0, 0, 0, 7, 7, 7, 7, 7, 7, 7, 7, 7, 7, 7, 7, 7, 7, 7, 7, 7, 7, 7, 7, 8, 0, 8, 0, 8, 0, 8, 0, 8, 0, 8, 0, 8, 0, 6, 0, 6, 0, 6, 0, 6, 0, 7, 7, 7, 7, 7, 7, 7, 7, 7, 7, 8, 0, 8, 0, 8, 0, 8, 0, 8, 0, 0, 0, 0, 0, 0, 0, 0, 0, 0, 0, 0, 0, 0, 0, 0, 7, 7, 7, 7, 7, 7, 7, 7, 7, 7, 7, 7, 7, 7, 7, 7, 7, 7, 7, 7],
	[9, 0, 0, 0, 0, 9, 6, 0, 6, 0, 6, 0, 6, 0, 6, 0, 6, 0, 6, 0, 6, 0, 6, 0, 6, 0, 8, 0, 8, 0, 8, 0, 8, 0, 8, 0, 8, 0, 8, 0, 8, 0, 6, 0, 6, 0, 6, 0, 6, 0, 7, 7, 7, 7, 7, 7, 7, 7, 7, 7, 8, 0, 8, 0, 8, 0, 8, 0, 8, 0, 6, 6, 6, 6, 6, 6, 6, 6, 6, 6, 6, 6, 6, 6, 0, 0, 0, 0, 0, 0, 0, 0, 0, 0, 0, 0, 0, 0, 0, 7, 7, 7, 7, 7, 7, 7, 7, 7, 7, 7, 7, 7, 7, 7, 7, 7, 7, 7, 7, 8, 0, 8, 0, 8, 0, 8, 0, 8, 0, 8, 0, 8, 0, 6, 0, 6, 0, 6, 0, 6, 0, 9, 9, 7, 7, 7, 7, 7, 7, 7, 7, 7, 7, 8, 0, 8, 0, 8, 0, 8, 0, 8, 0, 0, 0, 0, 0, 0, 0, 0, 0, 0, 0, 0, 0, 0, 0, 0, 7, 7, 7, 7, 7, 7, 7, 7, 7, 7, 7, 7, 7, 7, 7, 7, 7, 7, 7, 7]
], 
	"lvbg" : "url(assets/img/lvl3bg.png)",
	"lvindex" : 3,
	"hardmode" : false,
	"lvbgm" : "lvl3"
}