{
	"lvmap" : [
		0,0,1,0,0,0,0,0,0,0,
		0,0,1,0,0,0,1,1,1,0,
		0,0,1,2,2,2,1,3,1,0,
		0,0,1,0,0,0,1,3,1,0,
		0,0,1,0,0,0,1,0,1,0,
		0,0,1,3,3,0,1,0,1,1,
		0,0,1,1,3,1,1,0,0,0,
		0,0,0,1,1,1,0,0,0,0,
		0,0,0,0,0,0,0,0,0,0],
	"lvpath" : [2,12,22,32,42,52,62,63,73,74,75,65,66,56,46,36,26,16,17,18,28,38,48,58,59],
	"lvshort" : [2,12,22,23,24,25,26,16,17,18,28,38,48,58,59],
	"lvdirection" : [1, 2],
	"lvgold" : 20,
	"lvwaves" : [
		[1, 0, 0, 0, 0, 0, 0, 0, 1, 0, 0, 0, 0, 0, 0, 0, 1],
		[1, 0, 0, 0, 1, 0, 0, 0, 1, 0, 0, 0, 1, 0, 0, 0, 1],
		[1, 0, 0, 0, 1, 0, 0, 0, 1, 0, 0, 0, 1, 0, 0, 0, 1],
		[1, 0, 0, 0, 0, 0, 0, 1, 0, 0, 0, 0, 0, 7, 0, 0, 7],
		[1, 0, 0, 2, 0, 0, 0, 1, 0, 0, 2, 0, 0, 1, 0],
		[1, 0, 1, 0, 2, 0, 1, 0, 1, 0, 1, 0, 7, 7, 7],
		[1, 0, 1, 0, 2, 2, 1, 0, 1, 0, 2],
		[2, 1, 1, 0, 2, 2, 1, 1, 1, 0, 2, 0, 0, 0, 1, 1, 1],
		[2, 1, 1, 0, 2, 2, 1, 1, 1, 0, 2, 0, 0, 0, 1, 1, 1, 2, 1, 1, 0, 2, 2, 1, 1, 1, 0, 2, 0, 0, 0, 1, 1, 1],
		[2, 1, 1, 0, 2, 2, 1, 1, 1, 0, 2, 0, 0, 0, 1, 1, 1, 2, 1, 1, 0, 2, 2, 1, 1, 1, 0, 2, 0, 2, 0, 1, 1, 1, 2, 1, 1, 0, 2, 2, 1, 1, 1, 0, 2, 0, 0, 0, 1, 1, 1, 2, 1, 1, 0, 2, 2, 1, 1, 1, 0, 2, 0, 2, 0, 1, 1, 1],
		[2, 2, 2, 2, 2, 2, 1, 1, 1, 0, 2, 0, 0, 0, 1, 1, 1, 2, 1, 1, 0, 2, 2, 1, 1, 1, 0, 2, 2, 2, 2, 1, 1, 1, 2, 2, 2, 1, 1, 1, 0, 0, 0, 0, 7, 7, 7, 7, 7, 7, 7, 7, 7, 7, 7, 7, 7, 7, 7, 7, 7],
		[8, 0, 0, 8, 0, 0, 8, 0, 0, 8, 0, 0, 8, 0, 0, 8, 0, 0, 8, 0, 0, 8],
		[5, 0, 0, 5, 0, 0, 5, 0, 0, 5, 0, 0, 5, 0, 0, 0, 0, 7, 7, 7, 7, 7, 7, 7, 7, 7],
		[9, 0, 0, 0, 0, 0, 10, 0, 0, 0, 0, 0, 10, 0, 0, 0, 0, 0, 9],
		[3, 3, 3, 3, 3, 3, 0, 0, 0, 0, 0, 0, 0, 0, 0, 0, 0, 8, 0, 0, 8, 0, 0, 8, 0, 0, 8, 0, 0, 0, 0, 0, 0, 2, 7, 2, 7, 2, 7, 2, 7, 2, 7, 2, 7, 2, 7, 2, 7, 2, 7, 2, 7, 2, 7, 2, 7, 2, 1, 2, 1, 2, 1, 2, 1, 2, 2, 2, 1, 1, 1, 2, 2, 2],
		[5, 0, 5, 0, 5, 0, 5, 0, 5, 5, 0, 5, 0, 5, 0, 5, 0, 5, 5, 0, 0, 0, 8, 0, 0, 0, 0, 8, 0, 0, 8, 0, 0, 0, 8, 0, 0, 8, 0, 0, 0, 0, 0, 0, 7, 7, 7, 7, 7, 7, 7, 7, 0, 0, 0, 0, 0, 4, 4, 4, 4, 4, 4, 4, 4],
		[6, 0, 0, 0, 6, 0, 0, 0, 6, 0, 0, 0, 6, 0, 0, 0, 6, 0, 0, 0, 8, 0, 0, 8, 0, 0, 8, 0, 0, 8, 0, 0, 8],
		[10, 0, 0, 10, 0, 0, 9, 0, 0, 0, 0, 9, 0, 0, 0, 0, 9],
		[6, 0, 0, 0, 6, 0, 0, 0, 6, 0, 0, 0, 6, 0, 0, 0, 6, 0, 0, 0, 6, 0, 0, 0, 6, 0, 0, 0, 6, 0, 0, 0, 6, 8, 0, 0, 8, 0, 0, 8, 0, 0, 8, 0, 0, 8, 6, 0, 0, 0, 6, 0, 0, 0, 6, 0, 0, 0, 6, 0, 0, 0, 6, 0, 0, 0, 6, 0, 0, 0, 6, 0, 0, 0, 6, 0, 0, 0, 6, 0, 0, 0, 0, 0, 0, 0, 0, 8, 0, 0, 8, 0, 0, 8, 0, 0, 8, 0, 0, 8],
		[10, 0, 0, 10, 0, 0, 9, 0, 0, 0, 0, 9, 0, 0, 0, 0, 6, 0, 0, 0, 6, 0, 0, 0, 6, 0, 0, 0, 6, 0, 0, 0, 6, 0, 0, 0, 6, 0, 0, 0, 6, 0, 0, 0, 6, 0, 0, 0, 6, 8, 0, 0, 8, 0, 0, 8, 0, 0, 8, 0, 0, 8, 6, 0, 0, 0, 6, 0, 0, 0, 6, 0, 0, 0, 6, 0, 0, 0, 6, 0, 0, 0, 6, 0, 0, 0, 6, 0, 0, 0, 6, 0, 0, 0, 6, 0, 0, 0, 0, 0, 0, 0, 0, 8, 0, 0, 8, 0, 0, 8, 0, 0, 8, 0, 0, 8],
		[6, 0, 0, 0, 6, 0, 0, 0, 6, 0, 0, 0, 6, 0, 0, 0, 6, 0, 0, 0, 8, 0, 0, 8, 0, 0, 8, 0, 0, 8, 0, 0, 8, 5, 0, 5, 0, 5, 0, 5, 0, 5, 5, 0, 5, 0, 5, 0, 5, 0, 5, 5, 0, 0, 0, 6, 0, 6, 0, 6, 0, 6, 0, 6, 0, 6, 0, 6, 0, 6, 0, 6, 8, 0, 0, 0, 0, 8, 0, 0, 8, 0, 0, 0, 8, 0, 0, 8, 0, 0, 0, 0, 0, 0, 7, 7, 7, 7, 7, 7, 7, 7, 0, 0, 0, 0, 0, 4, 4, 4, 4, 4, 4, 4, 4],
		[6, 0, 0, 0, 6, 0, 0, 0, 6, 0, 0, 0, 6, 0, 0, 0, 6, 0, 0, 0, 8, 0, 0, 8, 0, 0, 8, 0, 0, 8, 0, 0, 8, 5, 0, 5, 0, 5, 0, 5, 0, 5, 5, 0, 5, 0, 5, 0, 5, 0, 5, 5, 0, 0, 0, 6, 0, 6, 0, 6, 0, 6, 0, 6, 0, 6, 0, 6, 0, 6, 0, 6, 5, 5, 5, 5, 5, 5, 5, 8, 0, 0, 0, 0, 8, 0, 0, 8, 0, 0, 0, 8, 0, 0, 8, 0, 0, 0, 0, 0, 0, 7, 7, 7, 7, 7, 7, 7, 7],
		[6, 0, 6, 0, 6, 0, 6, 0, 6, 0, 6, 0, 6, 0, 6, 0, 6, 0, 6, 0, 8, 0, 8, 0, 8, 0, 8, 0, 8, 0, 8, 0, 8, 0, 8, 0, 6, 0, 6, 0, 6, 0, 6, 0, 7, 7, 7, 7, 7, 7, 7, 7, 7, 7, 8, 0, 8, 0, 8, 0, 8, 0, 8, 0, 6, 6, 6, 6, 6, 6, 6, 6, 6, 6, 6, 6, 6, 6, 0, 0, 9, 0, 9, 0, 0, 8, 8, 0, 0, 0, 0, 0, 0, 7, 7, 7, 7, 7, 7, 7, 7, 7, 7, 7, 7, 7, 7, 7, 7, 7, 7, 7, 7],
		[6, 0, 6, 0, 6, 0, 6, 0, 6, 0, 6, 0, 6, 0, 6, 0, 6, 0, 6, 0, 8, 0, 8, 0, 8, 0, 8, 0, 8, 0, 8, 0, 8, 0, 8, 0, 6, 0, 6, 0, 6, 0, 6, 0, 7, 7, 7, 7, 7, 7, 7, 7, 7, 7, 8, 0, 8, 0, 8, 0, 8, 0, 8, 0, 6, 6, 6, 6, 6, 6, 6, 6, 6, 6, 6, 6, 6, 6, 0, 3, 9, 3, 0, 3, 9, 3, 0, 3, 0, 0, 0, 0, 0, 7, 7, 7, 7, 7, 7, 7, 7, 7, 7, 7, 7, 7, 7, 7, 7, 7, 7, 7, 7, 8, 0, 8, 0, 8, 0, 8, 0, 8, 0, 8, 0, 8, 0, 6, 0, 6, 0, 6, 0, 6, 0, 7, 7, 7, 7, 7, 7, 7, 7, 7, 7, 8, 0, 8, 0, 8, 0, 8, 0, 8, 0, 0, 9, 8, 9, 0, 8, 0, 8, 0, 8, 0, 0, 0, 0, 0, 7, 7, 7, 7, 7, 7, 7, 7, 7, 7, 7, 7, 7, 7, 7, 7, 7, 7, 7, 7],
		[9, 0, 0, 0, 0, 6, 0, 6, 0, 6, 0, 6, 0, 6, 0, 6, 0, 6, 0, 6, 0, 6, 0, 6, 0, 8, 0, 8, 0, 8, 0, 8, 0, 8, 0, 8, 0, 8, 0, 8, 0, 6, 0, 6, 0, 6, 0, 6, 0, 7, 7, 7, 7, 7, 7, 7, 7, 7, 7, 8, 0, 8, 0, 8, 0, 8, 0, 8, 0, 6, 6, 6, 6, 6, 6, 6, 6, 6, 6, 6, 6, 6, 6, 0, 3, 9, 3, 9, 3, 9, 3, 9, 3, 0, 0, 0, 0, 0, 7, 7, 7, 7, 7, 7, 7, 7, 7, 7, 7, 7, 7, 7, 7, 7, 7, 7, 7, 7, 8, 0, 8, 0, 8, 0, 8, 0, 8, 0, 8, 0, 8, 0, 6, 0, 6, 0, 6, 0, 6, 0, 9, 7, 7, 7, 7, 7, 7, 7, 7, 7, 7, 8, 0, 8, 0, 8, 0, 8, 0, 8, 0, 3, 9, 3, 8, 3, 9, 3, 8, 3, 10, 10, 0, 0, 0, 7, 7, 7, 7, 7, 7, 7, 7, 7, 7, 7, 7, 7, 7, 7, 7, 7, 7, 7, 7]
	],
	"lvbg" : "url(assets/img/lvl4bg.png)",
	"lvindex" : 7,
	"hardmode" : false,
	"lvbgm" : "lvl1"
}