{
	"lvmap" : [
		0,0,0,0,0,0,0,0,0,0,
		0,0,0,0,0,0,0,0,0,0,
		0,0,1,1,1,1,1,1,0,0,
		0,0,1,3,3,3,0,1,0,0,
		0,0,1,2,2,1,1,1,0,0,
		0,0,1,3,0,1,3,0,0,0,
		0,0,1,0,0,1,1,0,1,1,
		0,0,1,0,0,0,1,1,1,0,
		0,0,1,0,0,0,0,0,0,0],
	"lvpath" : [82,72,62,52,42,32,22,23,24,25,26,27,37,47,46,45,55,65,66,76,77,78,68,69],
	"lvshort" : [82,72,62,52,42,43,44,45,55,65,66,76,77,78,68,69],
	"lvdirection" : [3, 2],
	"lvgold" : 15,
	"lvwaves" : [
		[1, 0, 0, 0, 0, 0, 0, 0, 1, 0, 0, 0, 0, 0, 0, 0, 1],
		[1, 0, 0, 0, 1, 0, 0, 0, 1, 0, 0, 0, 1, 0, 0, 0, 1],
		[1, 0, 0, 0, 1, 0, 0, 0, 1, 0, 0, 0, 1, 0, 0, 0, 1],
		[1, 0, 0, 0, 0, 0, 0, 1, 0, 0, 0, 0, 0, 7, 0, 0, 7],
		[1, 0, 0, 2, 0, 0, 0, 1, 0, 0, 2, 0, 0, 1, 0],
		[1, 0, 1, 0, 2, 0, 1, 0, 1, 0, 1, 0, 7, 7, 7],
		[1, 0, 1, 0, 2, 2, 1, 0, 1, 0, 2],
		[2, 1, 1, 0, 2, 2, 1, 1, 1, 0, 2, 0, 0, 0, 1, 1, 1],
		[2, 1, 1, 0, 2, 2, 1, 1, 1, 0, 2, 0, 0, 0, 1, 1, 1, 2, 1, 1, 0, 2, 2, 1, 1, 1, 0, 2, 0, 0, 0, 1, 1, 1],
		[2, 1, 1, 0, 2, 2, 1, 1, 1, 0, 2, 0, 0, 0, 1, 1, 1, 2, 1, 1, 0, 2, 2, 1, 1, 1, 0, 2, 0, 2, 0, 1, 1, 1, 2, 1, 1, 0, 2, 2, 1, 1, 1, 0, 2, 0, 0, 0, 1, 1, 1, 2, 1, 1, 0, 2, 2, 1, 1, 1, 0, 2, 0, 2, 0, 1, 1, 1],
		[2, 2, 2, 2, 2, 2, 1, 1, 1, 0, 2, 0, 0, 0, 1, 1, 1, 2, 1, 1, 0, 2, 2, 1, 1, 1, 0, 2, 2, 2, 2, 1, 1, 1, 2, 2, 2, 1, 1, 1, 0, 0, 0, 0, 7, 7, 7, 7, 7, 7, 7, 7, 7, 7, 7, 7, 7, 7, 7, 7, 7],
		[8, 0, 0, 8, 0, 0, 8, 0, 0, 8, 0, 0, 8, 0, 0, 8, 0, 0, 8, 0, 0, 8],
		[5, 0, 0, 5, 0, 0, 5, 0, 0, 5, 0, 0, 5, 0, 0, 0, 0, 7, 7, 7, 7, 7, 7, 7, 7, 7],
		[9, 0, 0, 0, 0, 0, 10, 0, 0, 0, 0, 0, 10, 0, 0, 0, 0, 0, 9, 7, 7, 7, 7, 7, 7, 7, 7, 7],
		[3, 3, 3, 3, 3, 3, 0, 0, 0, 0, 0, 0, 0, 0, 0, 0, 0, 8, 0, 0, 8, 0, 0, 8, 0, 0, 8, 0, 0, 0, 0, 0, 0, 2, 7, 2, 7, 2, 7, 2, 7, 2, 7, 2, 7, 2, 7, 2, 7, 2, 7, 2, 7, 2, 7, 2, 7, 2, 1, 2, 1, 2, 1, 2, 1, 2, 2, 2, 1, 1, 1, 2, 2, 2],
		[5, 0, 5, 0, 5, 0, 5, 0, 5, 5, 0, 5, 0, 5, 0, 5, 0, 5, 5, 0, 0, 0, 8, 0, 0, 0, 0, 8, 0, 0, 8, 0, 0, 0, 8, 0, 0, 8, 0, 0, 0, 0, 0, 0, 7, 7, 7, 7, 7, 7, 7, 7, 0, 0, 0, 0, 0, 4, 4, 4, 4, 4, 4, 4, 4],
		[6, 0, 0, 0, 6, 0, 0, 0, 6, 0, 0, 0, 6, 0, 0, 0, 6, 0, 0, 0, 8, 0, 0, 8, 0, 0, 8, 0, 0, 8, 0, 0, 8],
		[11, 0, 0, 11, 0, 0, 9, 0, 0, 0, 0, 9, 0, 0, 0, 0, 9],
		[10, 10, 0, 0, 11, 11, 6, 0, 0, 0, 6, 0, 0, 0, 6, 0, 0, 0, 6, 0, 0, 0, 6, 0, 0, 0, 6, 0, 0, 0, 6, 0, 0, 0, 6, 0, 0, 0, 6, 8, 0, 0, 8, 0, 0, 8, 0, 0, 8, 0, 0, 8, 6, 0, 0, 0, 6, 0, 0, 0, 6, 0, 0, 0, 6, 0, 0, 0, 6, 0, 0, 0, 6, 0, 0, 0, 6, 0, 0, 0, 6, 0, 0, 0, 6, 0, 0, 0, 0, 0, 0, 0, 0, 8, 0, 0, 8, 0, 0, 8, 0, 0, 8, 0, 0, 8],
		[11, 0, 0, 11, 0, 0, 9, 0, 0, 0, 0, 9, 0, 0, 0, 0, 6, 0, 0, 0, 6, 0, 0, 0, 6, 0, 0, 0, 6, 0, 0, 0, 6, 0, 0, 0, 6, 0, 0, 0, 6, 0, 0, 0, 6, 0, 0, 0, 6, 8, 0, 0, 8, 0, 0, 8, 0, 0, 8, 0, 0, 8, 6, 0, 0, 0, 6, 0, 0, 0, 6, 0, 0, 0, 6, 0, 0, 0, 6, 0, 0, 0, 6, 0, 0, 0, 6, 0, 0, 0, 6, 0, 0, 0, 6, 0, 0, 0, 0, 0, 0, 0, 0, 8, 0, 0, 8, 0, 0, 8, 0, 0, 8, 0, 0, 8],
		[6, 0, 0, 0, 6, 0, 0, 0, 6, 0, 0, 0, 6, 0, 0, 0, 6, 0, 0, 0, 8, 0, 0, 8, 0, 0, 8, 0, 0, 8, 0, 0, 8, 5, 0, 5, 0, 5, 0, 5, 0, 5, 5, 0, 5, 0, 5, 0, 5, 0, 5, 5, 0, 0, 0, 6, 0, 6, 0, 6, 0, 6, 0, 6, 0, 6, 0, 6, 0, 6, 0, 6, 8, 0, 0, 0, 0, 8, 0, 0, 8, 0, 0, 0, 8, 0, 0, 8, 0, 0, 0, 0, 0, 0, 7, 7, 7, 7, 7, 7, 7, 7, 0, 0, 0, 0, 0, 4, 4, 4, 4, 4, 4, 4, 4],
		[6, 0, 0, 0, 6, 0, 0, 0, 6, 0, 0, 0, 6, 0, 0, 0, 6, 0, 0, 0, 8, 0, 0, 8, 0, 0, 8, 0, 0, 8, 0, 0, 8, 5, 0, 5, 0, 5, 0, 5, 0, 5, 5, 0, 5, 0, 5, 0, 5, 0, 5, 5, 0, 0, 0, 6, 0, 6, 0, 6, 0, 6, 0, 6, 0, 6, 0, 6, 0, 6, 0, 6, 5, 5, 5, 5, 5, 5, 5, 8, 0, 0, 0, 0, 8, 0, 0, 8, 0, 0, 0, 8, 0, 0, 8, 0, 0, 0, 0, 0, 0, 7, 7, 7, 7, 7, 7, 7, 7],
		[6, 0, 6, 0, 6, 0, 6, 0, 6, 0, 6, 0, 6, 0, 6, 0, 6, 0, 6, 0, 8, 0, 8, 0, 8, 0, 8, 0, 8, 0, 8, 0, 8, 0, 8, 0, 6, 0, 6, 0, 6, 0, 6, 0, 7, 7, 7, 7, 7, 7, 7, 7, 7, 7, 8, 0, 8, 0, 8, 0, 8, 0, 8, 0, 6, 6, 6, 6, 6, 6, 6, 6, 6, 6, 6, 6, 6, 6, 0, 0, 9, 0, 9, 0, 0, 8, 8, 0, 0, 0, 0, 0, 0, 7, 7, 7, 7, 7, 7, 7, 7, 7, 7, 7, 7, 7, 7, 7, 7, 7, 7, 7, 7],
		[6, 0, 6, 0, 6, 0, 6, 0, 6, 0, 6, 0, 6, 0, 6, 0, 6, 0, 6, 0, 8, 0, 8, 0, 8, 0, 8, 0, 8, 0, 8, 0, 8, 0, 8, 0, 6, 0, 6, 0, 6, 0, 6, 0, 7, 7, 7, 7, 7, 7, 7, 7, 7, 7, 8, 0, 8, 0, 8, 0, 8, 0, 8, 0, 6, 6, 6, 6, 6, 6, 6, 6, 6, 6, 6, 6, 6, 6, 0, 3, 9, 3, 0, 3, 9, 3, 0, 3, 0, 0, 0, 0, 0, 7, 7, 7, 7, 7, 7, 7, 7, 7, 7, 7, 7, 7, 7, 7, 7, 7, 7, 7, 7, 8, 0, 8, 0, 8, 0, 8, 0, 8, 0, 8, 0, 8, 0, 6, 0, 6, 0, 6, 0, 6, 0, 7, 7, 7, 7, 7, 7, 7, 7, 7, 7, 8, 0, 8, 0, 8, 0, 8, 0, 8, 0, 0, 9, 8, 9, 0, 8, 0, 8, 0, 8, 0, 0, 0, 0, 0, 7, 7, 7, 7, 7, 7, 7, 7, 7, 7, 7, 7, 7, 7, 7, 7, 7, 7, 7, 7],
		[9, 0, 0, 0, 0, 12, 6, 0, 6, 0, 6, 0, 6, 0, 6, 0, 6, 0, 6, 0, 6, 0, 6, 0, 6, 0, 8, 0, 8, 0, 8, 0, 8, 0, 8, 0, 8, 0, 8, 0, 8, 0, 6, 0, 6, 0, 6, 0, 6, 0, 7, 7, 7, 7, 7, 7, 7, 7, 7, 7, 8, 0, 8, 0, 8, 0, 8, 0, 8, 0, 6, 6, 6, 6, 6, 6, 6, 6, 6, 6, 6, 6, 6, 6, 12, 0, 3, 9, 3, 9, 3, 9, 3, 9, 3, 0, 0, 0, 0, 0, 7, 7, 7, 7, 7, 7, 7, 7, 7, 7, 7, 7, 7, 7, 7, 7, 7, 7, 7, 7, 8, 0, 8, 0, 8, 0, 8, 0, 8, 0, 8, 0, 8, 0, 6, 0, 6, 0, 6, 0, 6, 0, 9, 7, 7, 7, 7, 7, 7, 7, 7, 7, 7, 8, 0, 8, 0, 8, 0, 8, 0, 8, 0, 3, 9, 3, 8, 3, 9, 3, 8, 3, 11, 11, 0, 0, 0, 7, 7, 7, 7, 7, 7, 7, 7, 7, 7, 7, 7, 7, 7, 7, 7, 7, 7, 7, 7]
	],
	"lvbg" : "url(assets/img/lvl5bg.png)",
	"lvindex" : 11,
	"hardmode" : true,
	"lvbgm" : "lvl4"
}